

R 1920 1080

NO texture/redbrick.xpm

SO texture/mossy.xpm

WE texture/wood.xpm

EA texture/greystone.xpm

S texture/barrel.xpm

F 215,180,120
C 155,48,79

 11111111111111
10000000000001
10000000000000111111111
11111000000000000000001
     1111000000000011111111
     10000000000111
      1000000000011       111111
       111111111000111111100201111111
        1111111111000000000000000000111111111
                  11111100000000000000111111
             1111111111000000000000001
    1111111110000000200000W11111111111
    1000000000000000000000001
    1000000200000000000000001
    1000000111111111111110011
    10000001             11  1111
    10000000111111111       10000111111
    100000000000000001111111000000000001
     1111111111111100000000000111111110011
                   11111100111  11111100111
                        10001111110000001
                        1000000000000111
                        10001111111111
                        11111