

R 1920 1080

NO texture/Wallsnk.png

SO texture/purplestone.png

WE texture/wood.png

EA texture/greystone.png

S texture/pillar.png

F 215,180,120
C 155,48,79


 11111111111111
10000000000001
10000000000000111111111
11111000000000000000001
     1111000000000011111111
     10000000000111
      1000000000011       111111
       111111111000111111100201111111        111        1      1      1    1
        1111111111020000000000000000111111111
                  11111100000000000000111111        1111      1      1      1111
             111111111100000W000000001    1    1      1    1      1      1      1    1
    1111111110000000020000011111111111  1111111111111    1
    1000000000000000000000001
    1002000002000000000000001
    1000000111111111111110011          111
    10000001             11  1111     10001
    1000000011111111        100001     111
    10000000000000011111111101111
     11111111111111000000000001       11
                   11111111111  11111100111
                                      11
                         111      11
                        1000111111001
                        1000000001111
                        100011111
                        1111