

R 1920 1080

NO texture/redbrick.xpm

SO texture/mossy.xpm

WE texture/wood.xpm

EA texture/greystone.xpm

S texture/barrel.xpm

F texture/mossy.xpm
C texture/wood.xpm
   
                                              1   
                                             101  
                                             1001 
                                            11101 
                                           1000001
                                           100011 
                   11                     1000001 
                  1001111                  100201 
                  10000001                 100001 
                  10200021                  10001 
                 100000001                   1001 
                1000000001                   1001 
                1000011001                   1N001
                100100001                    10001
                10010001                     10001
                 11200011                    10101
                  10000001                   1011 
                   100000111                 1011 
                  11001000001                10001
                 100000100001      1   1111   1101
                 1010000000001   11011100001  1001
                100110011000001110000000001    101
              111001 11 100000001000100000111 1101
             1000001    10001000000000000100010001
              101001    10000000011100000000000101
             11010001    1110000001100000010001 1 
            100000021      100000000011000000001  
            102000001      100000100000001000001  
            100011001      10000000000111000001   
             111 100111   100000200111  1000001   
                 1000001 10000001101     1000001  
                 100010110000001  1       10001   
                  1110000021001            111    
                     111111 11                