

R 1920 1080

NO texture/redbrick.xpm

SO texture/mossy.xpm

WE texture/wood.xpm

EA texture/greystone.xpm

S texture/barrel.xpm

F texture/greystone.xpm
C texture/wood.xpm
   
 11111111111111
10000000000001
10000000000000111111111
11111000000000000000001
     1111000000000011111111
     10000000000111
      1000000000011       111111
       111111111000111111100201111111        
        1111111111000000000000000000111111111
                  11111100000000000000111111
             1111111111000000000000001
    1111111110000000200000W11111111111
    1000000000000000000000001
    1000000200000000000000001
    1000000111111111111110011
    10000001             11  1111
    100000001111111111111111100001
    10000000000000000000000000111
     11111111111111000000000001
                   11111111111